1111
10E1
10C1
10C1
10P1
1111
